NO ./Sprites/Texture_Side1.png
SO ./Sprites/Texture_Side1.png
WE ./Sprites/Texture_Side1.png
EA ./Sprites/Texture_Side1.png
F 78,52,46
C 78,52,466
1111 111111
1100111010W1
11000110000111111111111
 10001 10000000000000001
11000010000111111111111
1000011101001
111111 111111