111111 111111
1000011101001
1100011000011
 10001 10001
1100001000011
10000111W1001
111111 111111