NO ./Sprites/Texture_Side.png
SO ./Sprites/Texture_Side.png
WE ./Sprites/Texture_Side.png
EA ./Sprites/Texture_Side.png
F 78,52,46
C 78,52,466
11111 111111
110011101001
11000110000111111111111
 10001100W0000000000001
11000010000111111111111
1000011101001
1000011101001
1000011101001
1000011101001
111111 111111